
7 7 
2 2 2 2 2 2 2
2 1 1 4 1 1 2
2 1 3 5 3 1 2
2 5 7 2 7 5 2
2 1 3 5 3 1 2
2 1 1 1 1 1 2
2 2 2 2 2 2 2