
7 9
2 2 2 2 2 2 2 2 2
2 1 1 2 2 2 2 2 2
2 1 1 1 1 4 1 2 2
2 1 5 7 5 3 7 1 2
2 2 1 1 2 3 1 1 2
2 2 2 1 1 1 2 2 2
2 2 2 2 2 2 2 2 2