6 8
1 2 2 2 2 2 2 1
2 2 1 1 1 1 2 2
2 1 5 5 1 1 1 2
2 1 6 1 3 3 3 2
2 1 1 1 6 4 5 2
2 2 2 2 2 2 2 2