
10 10
2 2 2 2 2 2 2 2 2 2
2 2 1 2 5 1 1 2 2 2
2 1 1 7 5 7 1 1 2 2
2 1 3 2 5 2 3 1 1 2
2 1 3 1 1 1 3 1 1 2
2 2 2 2 2 2 2 1 1 2
2 1 1 1 2 2 2 1 1 2
2 1 3 5 3 5 3 1 1 2
2 2 1 5 4 5 1 1 2 2
2 2 2 2 2 2 2 2 2 2 
