5 7
2 2 2 2 2 2 2
2 1 1 3 1 5 2
2 1 1 2 2 2 2
2 1 4 2 1 1 1
2 2 2 2 1 1 1
