6 7
2 2 2 2 2 2 2
2 1 1 2 5 2 2
2 1 3 3 3 5 2
2 1 1 3 1 1 2
2 4 1 2 5 5 2
2 2 2 2 2 2 2