
7 6
2 2 2 2 2 2
2 1 1 2 2 2
2 1 5 1 2 2 
2 5 5 3 2 2
2 4 3 3 1 2
2 1 1 1 1 2
2 2 2 2 2 2