

8 8
2 2 2 2 2 2 2 2
2 2 1 1 2 1 1 1
2 2 1 1 2 2 2 2
2 2 1 5 5 3 4 2
2 2 1 3 3 1 1 2
2 1 1 1 2 2 2 2
2 1 1 1 2 1 1 1
2 2 2 2 2 2 2 2