
10 8
2 2 2 2 2 2 2 2
2 2 1 2 5 1 5 2
2 1 1 3 1 5 1 2
2 1 3 2 5 3 5 2
2 1 1 3 1 5 1 2
2 2 1 2 3 1 2 2
2 1 3 1 1 2 2 2
2 1 1 1 2 2 2 2
2 4 1 2 2 2 2 2
2 2 2 2 2 2 2 2