7 7
1 2 2 2 2 2 1
2 2 4 1 1 2 2
2 1 1 6 1 1 2
2 1 3 7 3 1 2
2 1 1 5 1 1 2
2 2 1 5 1 1 2
1 2 2 2 2 2 2