6 7
2 2 2 2 2 2 1
2 4 7 1 1 2 2
2 1 3 6 1 1 2
2 1 3 1 5 1 2
2 5 1 1 1 2 2
2 2 2 2 2 2 1