
7 7
1 1 2 2 2 2 1
2 2 2 1 1 2 1
2 4 1 5 3 2 2
2 1 1 1 3 1 2
2 1 6 5 1 1 2
2 1 1 1 1 1 2
2 2 2 2 2 2 2