7 8
1 2 2 2 2 2 1 1
2 2 5 1 1 2 2 2
2 1 1 6 1 3 4 2
2 1 1 6 1 6 1 2
2 1 7 1 1 3 5 2
2 1 1 1 1 2 2 2
2 2 2 2 2 2 1 1

