8 9
2 2 2 2 2 2 2 2 2
2 1 1 1 2 2 2 2 2
2 1 1 5 3 1 2 2 2
2 2 1 5 2 1 3 1 2
2 2 1 5 2 1 3 4 2
2 2 2 5 1 1 3 1 2
2 2 2 1 1 2 2 2 2
2 2 2 2 2 2 2 2 2