
9 8
2 2 2 2 2 2 2 2
2 2 2 2 1 1 2 2
2 2 2 1 1 1 2 2
2 2 1 2 7 1 2 2
2 1 1 7 5 1 1 2
2 1 1 1 1 7 1 2
2 2 2 2 3 1 1 2
2 2 2 2 1 4 2 2
2 2 2 2 2 2 2 2