6 8
2 2 2 2 2 2 1 1
2 1 1 1 1 2 2 2
2 1 1 1 5 5 1 2
2 1 3 3 3 4 1 2
2 1 1 6 1 5 1 2
2 2 2 2 2 2 2 2