5 7
2 2 2 2 2 2 2
2 1 1 3 1 5 2
2 1 1 2 2 2 2
2 1 4 2 1 1 1
2 2 2 2 1 1 1

7 7
2 2 2 2 2 2 2
2 1 1 4 3 1 2
2 1 3 1 1 1 2
2 1 1 1 1 1 2
2 1 1 1 3 5 2
2 1 1 1 1 1 2
2 2 2 2 2 2 2

7 7
1 1 2 2 2 2 2
2 2 2 5 3 1 2
2 1 1 1 1 1 2
2 1 1 1 1 1 2
2 1 1 3 5 1 2
2 4 1 1 2 2 2
2 2 2 2 2 1 1

7 9
1 1 1 1 1 2 2 2 2
1 2 2 2 1 2 5 1 2
1 2 4 2 2 2 1 1 2
2 2 1 1 1 1 1 1 2
2 5 1 1 3 1 3 2 2
2 1 1 1 1 1 1 2 1
2 2 2 2 2 2 2 2 1


7 7
1 1 2 2 2 2 1
2 2 2 1 1 2 1
2 4 1 5 3 2 2
2 1 1 1 3 1 2
2 1 6 5 1 1 2
2 1 1 1 1 1 2
2 2 2 2 2 2 2

7 7
1 2 2 2 2 2 1
2 2 4 1 1 2 2
2 1 1 6 1 1 2
2 1 3 7 3 1 2
2 1 1 5 1 1 2
2 2 1 5 1 1 2
1 2 2 2 2 2 2

6 8
2 2 2 2 2 2 1 1
2 1 1 1 1 2 2 2
2 1 1 1 5 5 1 2
2 1 3 3 3 4 1 2
2 1 1 6 1 5 1 2
2 2 2 2 2 2 2 2

7 8
1 2 2 2 2 2 1 1
2 2 5 1 1 2 2 2
2 1 1 6 1 3 4 2
2 1 1 6 1 6 1 2
2 1 7 1 1 3 5 2
2 1 1 1 1 2 2 2
2 2 2 2 2 2 1 1

6 7
2 2 2 2 2 2 1
2 4 7 1 1 2 2
2 1 3 6 1 1 2
2 1 3 1 5 1 2
2 5 1 1 1 2 2
2 2 2 2 2 2 1

6 8
1 2 2 2 2 2 2 1
2 2 1 1 1 1 2 2
2 1 5 5 1 1 1 2
2 1 6 1 3 3 3 2
2 1 1 1 6 4 5 2
2 2 2 2 2 2 2 2

7 6
2 2 2 2 2 2
2 1 1 2 2 2
2 1 5 1 2 2 
2 5 5 3 2 2
2 4 3 3 1 2
2 1 1 1 1 2
2 2 2 2 2 2

7 8
2 2 2 2 2 2 2 2
2 2 2 1 1 2 2 2
2 2 2 1 5 1 1 2
2 1 3 3 3 1 1 2
2 1 1 4 2 5 1 2
2 2 2 5 1 1 2 2 
2 2 2 2 2 2 2 2

8 8
2 2 2 2 2 2 2 2
2 2 1 1 2 1 1 1
2 2 1 1 2 2 2 2
2 2 1 5 5 3 4 2
2 2 1 3 3 1 1 2
2 1 1 1 2 2 2 2
2 1 1 1 2 1 1 1
2 2 2 2 2 2 2 2

8 9
2 2 2 2 2 2 2 2 2
2 1 1 1 2 2 2 2 2
2 1 1 5 3 1 2 2 2
2 2 1 5 2 1 3 1 2
2 2 1 5 2 1 3 4 2
2 2 2 5 1 1 3 1 2
2 2 2 1 1 2 2 2 2
2 2 2 2 2 2 2 2 2

7 9
2 2 2 2 2 2 2 2 2
2 1 1 2 2 2 2 2 2
2 1 1 1 1 4 1 2 2
2 1 5 7 5 3 7 1 2
2 2 1 1 2 3 1 1 2
2 2 2 1 1 1 2 2 2
2 2 2 2 2 2 2 2 2

10 10
2 2 2 2 2 2 2 2 2 2
2 2 1 2 5 1 1 2 2 2
2 1 1 7 5 7 1 1 2 2
2 1 3 2 5 2 3 1 1 2
2 1 3 1 1 1 3 1 1 2
2 2 2 2 2 2 2 1 1 2
2 1 1 1 2 2 2 1 1 2
2 1 3 5 3 5 3 1 1 2
2 2 1 5 4 5 1 1 2 2
2 2 2 2 2 2 2 2 2 2 

10 8
2 2 2 2 2 2 2 2
2 2 1 2 5 1 5 2
2 1 1 3 1 5 1 2
2 1 3 2 5 3 5 2
2 1 1 3 1 5 1 2
2 2 1 2 3 1 2 2
2 1 3 1 1 2 2 2
2 1 1 1 2 2 2 2
2 4 1 2 2 2 2 2
2 2 2 2 2 2 2 2

9 8
2 2 2 2 2 2 2 2
2 2 2 2 1 1 2 2
2 2 2 1 1 1 2 2
2 2 1 2 7 1 2 2
2 1 1 7 5 1 1 2
2 1 1 1 1 7 1 2
2 2 2 2 3 1 1 2
2 2 2 2 1 4 2 2
2 2 2 2 2 2 2 2

6 7
2 2 2 2 2 2 2
2 1 1 2 5 2 2
2 1 3 3 3 5 2
2 1 1 3 1 1 2
2 4 1 2 5 5 2
2 2 2 2 2 2 2

7 7 
2 2 2 2 2 2 2
2 1 1 4 1 1 2
2 1 3 5 3 1 2
2 5 7 2 7 5 2
2 1 3 5 3 1 2
2 1 1 1 1 1 2
2 2 2 2 2 2 2