5 5
2 2 2 2 2
2 1 1 5 2
2 1 3 1 2
2 4 1 1 2
2 2 2 2 2

5 5
2 2 2 2 2
2 1 1 1 2
2 4 3 5 2
2 1 1 1 2
2 2 2 2 2


6 6
2 2 2 2 2 2
2 1 1 1 1 2
2 1 3 5 1 2
2 4 1 1 1 2
2 1 1 1 1 2
2 2 2 2 2 2

6 6
2 2 2 2 2 2
2 1 1 5 2 2
2 1 3 1 2 2
2 4 1 1 2 2
2 2 2 2 2 2
2 1 2 2 1 1

6 6
2 2 2 2 2 2
2 1 1 5 2 2
2 1 3 1 2 2
2 4 1 1 2 2
1 2 2 2 2 2
1 2 2 2 2 2

6 6
2 2 2 2 2 1
2 1 1 5 2 2
2 1 3 1 2 1
2 4 1 1 2 2
2 2 2 2 2 1
1 2 1 2 1 2